000000010000000
000000000000000
000000000000000
100000000000000
111100010000000
000000011100001
000000000100001
000000000100000
000100000000000
111100000000000
000000000000000
000000000000000
000000000000001
000000000000001
000011111100001
000000000000011
000000000000000
000000000000000
000000000000000
000000000000000
